{	
	"file": "tiles.png",
	"tile_height": 80,
	"tile_width": 80,
	"level_height": 960,
	"level_width": 1280,
	"tile_sprites": 12,	
	"map": [
				0,1,2,0,1,2,0,1,2,0,1,2,0,1,2,0,
				1,2,0,1,2,0,1,2,0,1,2,0,1,2,0,1,
				2,0,11,4,4,4,4,4,4,4,4,4,4,5,1,2,
				0,1,10,3,3,3,3,3,3,3,3,3,3,6,2,0,
				1,2,10,3,8,8,8,8,8,8,8,3,3,6,0,1,
				2,0,10,6,0,1,2,0,1,2,0,10,3,6,1,2,
				0,1,10,6,1,11,5,1,2,0,1,10,3,6,2,0,
				1,2,10,6,2,9,7,2,0,1,2,10,3,6,0,1,
				2,0,10,6,0,1,2,0,1,2,0,10,3,6,1,2,
				0,1,10,3,4,4,4,5,2,0,1,9,8,7,2,0,
				1,2,9,8,8,8,8,7,0,1,2,0,1,2,0,1,
				2,0,1,2,0,1,2,0,1,2,0,1,2,0,1,2
			],
	"clips": [
				[0, 0, 80, 80],
				[0, 80, 80, 80],
				[0, 160, 80, 80],
				[160, 80, 80, 80],
				[160, 0, 80, 80],
				[240, 0, 80, 80],
				[240, 80, 80, 80],
				[240, 160, 80, 80],
				[160, 160, 80, 80],
				[80, 160, 80, 80],			
				[80, 80, 80, 80],
				[80, 0, 80, 80]
			]
}